D[1],D[2],D[3],D[4],D[5],D[6],OUT
0,0,0,0,0,0,0
1,0,0,0,0,0,1
0,1,0,0,0,0,0
1,1,0,0,0,0,0
0,0,1,0,0,0,0
1,0,1,0,0,0,1
0,1,1,0,0,0,1
1,1,1,0,0,0,1
0,0,0,1,0,0,0
1,0,0,1,0,0,0
0,1,0,1,0,0,0
1,1,0,1,0,0,0
0,0,1,1,0,0,0
1,0,1,1,0,0,0
0,1,1,1,0,0,0
1,1,1,1,0,0,0
0,0,0,0,1,0,0
1,0,0,0,1,0,1
0,1,0,0,1,0,0
1,1,0,0,1,0,0
0,0,1,0,1,0,0
1,0,1,0,1,0,1
0,1,1,0,1,0,1
1,1,1,0,1,0,1
0,0,0,1,1,0,0
1,0,0,1,1,0,0
0,1,0,1,1,0,1
1,1,0,1,1,0,1
0,0,1,1,1,0,0
1,0,1,1,1,0,0
0,1,1,1,1,0,1
1,1,1,1,1,0,1
0,0,0,0,0,1,0
1,0,0,0,0,1,1
0,1,0,0,0,1,0
1,1,0,0,0,1,0
0,0,1,0,0,1,0
1,0,1,0,0,1,1
0,1,1,0,0,1,1
1,1,1,0,0,1,1
0,0,0,1,0,1,1
1,0,0,1,0,1,1
0,1,0,1,0,1,0
1,1,0,1,0,1,0
0,0,1,1,0,1,1
1,0,1,1,0,1,1
0,1,1,1,0,1,0
1,1,1,1,0,1,0
0,0,0,0,1,1,0
1,0,0,0,1,1,1
0,1,0,0,1,1,0
1,1,0,0,1,1,0
0,0,1,0,1,1,0
1,0,1,0,1,1,1
0,1,1,0,1,1,1
1,1,1,0,1,1,1
0,0,0,1,1,1,1
1,0,0,1,1,1,1
0,1,0,1,1,1,1
1,1,0,1,1,1,1
0,0,1,1,1,1,1
1,0,1,1,1,1,1
0,1,1,1,1,1,1
1,1,1,1,1,1,1
